############################
#       ######             #
#    ####    #####         #
#                ###       #
#    #####                 #
#         ######           #
#   ###                    #
#   #########      ####    #
#                          #
#              #####       #
############################