############################
#         #                #
#   ####  #   ##########   #
#   #     #          #     #
#   #     #######    #     #
#   #                #     #
#   ###########      #     #
#                #####     #
#                          #
#                          #
############################