############################
#     #           #        #
# ### # ######### # ###### #
# #   #       #   #      # #
# # ####### # # ####### ## #
# #       # # #       #    #
# ####### # # ####### ######
#       # # #              #
####### # # ############## #
#         #                #
############################