############################
#                          #
#      ###########         #
#      #         #         #
#      #  #####  #         #
#      #  #   #  #         #
#      #  #####  #         #
#      #         #         #
#      ###########         #
#                          #
############################