############################
#         #                #
#         #      ####      #
#         #                #
#         ######           #
#                          #
#              #######     D
#                          #
#     ####                 #
#                          #
############################